TANKS=5
MAX_TANKS=1
MAP=
                         X
                         X
##$$  $$$$$$  $$$$$$  $$##
  ##  ##  ##  ##  ##  ## X
  ##  ##  ##  ##  ##  ## X
  ##  ##  ##  ##  ##  ## X
  ##  ##  ##  ##  ##  ## X
  ##  ##############  ## X
  ##      ##  ##      ## X
P ##      ##F ##      ## X